1111111111 
1010000001 
1010101001 
1010000001 
1011110001 
1000000001 
1010101111 
1010101111 
1010101111 
1111111111 